⺋	stamp; fingerprint (distinguish from "chop-seal")
⺌	small
⺗	valentine
⺼	flesh
⻌	road
⻟	eat, food
ヨ	broom (distinguish from writing-brush)
一	One
丁	Fourth
七	Seven
万	Ten Thousand
丈	100 Chinese inches
三	Three
上	Above
下	Below
不	No
与	Offer
丑	Clown
专	Specialty
且	Moreover
世	Generation
丘	Hill
丙	Third
业	Profession
东	East
丝	Silk
两	Dos
严	Strict
丧	Funeral
丨	walking stick
个	Individual
丬	[left-side kata] | turtle
中	Middle
丰	Plentiful
临	Be about to
丶	a drop of
丸	Pill
为	Act
主	Lord
丽	Lovely
举	Lift up
丿	[kana no]
乃	Only then
久	Long time
么	(suffix)
义	Righteousness
之	Of
乍	For the first time
乎	Ooh!
乏	Weary
乐	Music
乔	Pretend
乙	Second | fish guts
乚	fish hook
九	Nine
乞	Beg
也	Also
习	Learn
乡	Countryside
书	Book
买	Buy
乱	Chaos
亀	tortoise
亅	[barb]
了	(-ed)
予	Bestow
争	Contend
事	Matter
二	Two
于	Yu
云	Cloud
互	Mutual
五	Five
井	Well
亚	Asia
些	Somewhat
亠	top hat
亡	Deceased
交	Mingle
亥	Sign of the Hog
亦	Likewise
产	Products
亩	Chinese acre
享	Enjoy
京	Capital
亭	Pavilion
亮	Shiny
亲	Relatives
人	(on top) umbrella | person | Person
亻	person
什	What?
仁	Benevolence
仅	Merely
今	Now
介	Introduce
仍	Still
从	Follow
仓	Storehouse
他	He
付	Pay
代	Substitute for
令	Orders
以	By means of
仪	Deliberate
们	(plural)
仰	Look up to
件	Piece
价	Price
任	Appoint
份	Portion
企	Look forward to
伊	Queen Elizabeth
休	Rest
众	Multitude
优	Excellent
会	Meeting
伟	Great
传	Spread
伤	Wound
伪	Bogus
伴	Partner
伸	Extend
似	Similar
但	However
位	Position
低	Low
住	Dwell
体	Body
何	Whatwhichwhowherewhy?
余	Excess
佛	Buddha
作	Do
你	You
使	Use
例	Example
供	Supply
依	Depend on
侣	Associate
侯	Marquis
便	Convenient
保	Safeguard
信	Faith
俩	Duo
修	Repair
俯	Bow one’s head
倒	Upside down
候	Wait
借	Borrow
值	Value
假	Vacation
做	Make
停	Halt
健	Healthy
像	Likeness
儒	Confucian
儿	Youngster | human legs
元	Beginning
兄	Elder Brother
充	Sufficient
兆	Portent
先	Before
光	Ray
克	Overcome
免	Avoid
兑	Convert
兔	Rabbit
党	Political Party
入	Enter
全	Whole
八	(on top) open umbrella | eight; animal legs | Eight
公	Public
六	Six
兰	Orchid
共	Together
关	Shut
兴	Excitement
兵	Troops
其	His-hers-its-theirs
具	Tool
典	Canon
养	Raise
冂	hood
内	Internal
冈	Ridge of a hill
再	Once more
冒	Risk
冖	crown
冗	Superfluous
写	Write
军	Army
农	Agriculture
冠	Crown
冫	ice
冬	Winter
冰	Ice
冲	Collide
决	Decide
况	Situation
冷	Cold
冻	Freeze
净	Clean
准	Standard
凉	Cool
减	Reduce
几	How many? | wind
凡	Ordinary
凵	shovel
凶	Cruel
凸	Convex
凹	Concave
出	Exit
击	Beat
刀	Sword | sword, dagger
刂	saber
刃	Blade
分	Part
切	Cut
刑	Punishment
划	Scratch
列	Line up
则	Rule
刚	Just now
创	Initiate
初	Elementary
判	Judge
利	Profit
别	Don’t
到	Arrive
制	System
刺	Thorn
刻	Carve
削	Peel
前	In front
剧	Drama
剪	Shears
副	Vice-
割	Cut off
力	Power | power, muscle
办	Manage
功	Achievement
加	Add
务	Tasks
动	Move
助	Assist
努	Toil
励	Encourage
劳	Labor
势	Force
勇	Courageous
勒	Tighten
勤	Diligent
勹	bound up
勺	Ladle
勿	Not
匀	Uniform
包	Wrap
匕	Ancient Spoon | spoon
化	Transform
北	North
匚	box (on its side)
匸	[hiding]
区	Region
医	Physician
十	Ten
千	Thousand
升	Liter
午	Noon
半	Half
华	Splendor
协	Cooperate
卑	Lowly
卓	Eminent
单	List
卖	Sell
南	South
博	Knowledgeable
卜	Divination | magic wand
占	Tell Fortunes
卡	Card
卩	stamp; fingerprint (distinguish from "chop-seal")
卫	Defend
印	Print
危	Danger
即	Immediately
却	Withdraw
厂	Factory | cliff
厅	Hall
历	Experience
厉	Stern
压	Pressure
厌	Detest
厚	Thick
原	Flatlands
厨	Kitchen
厶	elbow
去	Go
县	County
参	Participate
又	Again | crotch
及	Catch up with
友	Friend
双	Pair
反	Against
发	Send out
叔	Uncle
取	Take
受	Accept
变	Change
口	Mouth
古	Ancient
句	Sentence
另	Another
只	Only
叫	Call
召	Summon
叮	Sting
可	Can
台	Platform
史	History
右	Right
叶	Leaf
号	Appellation
司	Take charge of
吃	Eat
各	Each
合	Fit
吉	Lucky
同	Same
名	Name
后	Behind
吐	Spit
向	Orientation
吕	Spine
吗	Yes or no
君	Monarch
否	Negate
吧	Bar
含	Harbor
听	Listen
吴	Wu
吵	Noisy
吸	Inhale
吹	Blow
吼	Roar
吾	I (literary)
呀	Wow!
呆	Dim-witted
呈	Submit
告	Declare
呐	Holler
员	Employee
呢	Woolen cloth
周	Circumference
味	Flavor
呼	Shout
命	Fate
和	Harmony
咨	Consult with
咸	Salty
哀	Grief
品	Goods
哇	Waaah!
哈	Ha!
响	Echo
哗	Clamor
哥	Older Brother
哪	Which?
哭	Cry
哲	Philosopher
唐	Tang
唤	Call out
售	Vend
唱	Sing
商	Salesman
啊	Aah!
啦	!!
善	Virtuous
喜	Joyful
喝	Drink
嘲	Ridicule
嘴	Orifice
器	Utensil
囗	pent in
四	Four
回	Return
因	Cause
团	Troupe
园	Park
困	Trapped
围	Surround
固	Solid
国	Country
图	Picture
圆	Round
土	Soil
圣	Holy
在	At
地	Ground
场	Site
均	Equal
坏	Bad
坐	Sit
坑	Pit
块	Lump
坚	Firm
坠	Crash
坪	Level ground
垂	Droop
型	Mold
埋	Bury
城	City
培	Cultivate
基	Base
堂	Main Room
堡	Fort
塔	Pagoda
填	Fill in
境	Boundary
墓	Grave
增	Increase
墨	Black Ink
壁	Partition
壤	Territory
士	Soldier | samurai
壮	Robust
声	Voice
夂	walking legs
处	Location
备	Prepare
夊	walking legs
复	Duplicate
夏	Summer
夕	Evening
外	Outside
多	Many
夜	Night
够	Enough
大	Large | big (St. Bernard)
天	Heavens
太	Overly
夫	Husband
夭	Die young
央	Center
失	Lose
头	Head
奇	Strange
奉	Proffer
套	Cover
女	Woman
奴	Slave
奶	Milk
她	She
好	Good
如	Be like
妄	Absurd
妆	Put on makeup
妇	Married woman
妈	Mama
妙	Wonderful
妨	Hinder
妹	Younger sister
始	Commence
姐	Older sister
姓	Surname
委	Committee
姿	Looks
威	Might
娇	Attractive
娘	Mom
娱	Amusement
婆	Old woman
婚	Marriage
子	Child
孔	Cavity
字	Character
存	Deposit
孙	Grandchild
孝	Filial piety
季	Seasons
孤	Orphan
学	Study
孩	Tot
宀	house
它	It
宅	Dwelling
宇	Eaves
守	Guard
安	Peaceful
完	Finish
宗	Religion
官	Bureaucrat
定	Settle on
宝	Treasure
实	Reality
客	Guest
宣	Proclaim
室	Room
害	Harm
宴	Banquet
宵	Nighttime
家	House
容	Contain
宽	Wide
寂	Lonely
寄	Mail
寅	Sign of the Tiger
密	Secret
富	Wealthy
寒	Frigid
察	Scrutinize
寸	Chinese inch | inch, glue
对	That’s right
寺	Buddhist temple
寻	Seek
导	Guide
封	Seal
射	Shoot
将	General (military rank)
尊	Venerate
小	Small
少	Few
尔	You (literary)
尖	Tip
尘	Dust
尚	Esteem
尢	big dog with one human leg
尤	Remarkable
尧	Yao
就	At once
尸	Corpse | flag
尹	Overseer
尺	Ruler
尼	Nun
尽	Exhausted
尾	Tail
局	Bureau
层	Story
居	Reside
屋	Habitation
展	Unfold
属	Belong to
屮	[old grass]
山	Mountain
岁	Years of age
岛	Island
岸	Shore
崇	Worship
巛	stream
川	Stream
州	State
巡	Patrol
工	Work | craft
左	Left
巧	Adroit
巫	Witch
差	Fall short of
己	Self | snake
已	Already | snake
巳	snake
巴	Crust
巷	Lane
巾	Towel
市	Market
布	Cloth
帅	Commander
师	Teacher
希	Hope
帜	Streamer
帝	Sovereign
带	Sash
席	Mat
帮	Help
常	Often
帽	Hat
幕	Curtain
干	Dry | dry (clothesline)
平	Even
年	Year
并	Combine
幸	Good fortune
幺	cocoon
幻	Unreal
广	Extensive | cave
庄	Hamlet
床	Bed
序	Preface
库	Warehouse
应	Ought to
底	Bottom
店	Store
府	Government office
废	Discard
度	Degrees
座	Seat
庭	Court of law
康	Hale
廴	stretch
延	Prolong
廷	Royal court
建	Build
廾	two hands
廿	Twenty
开	Open
异	Different
弄	Play with
弋	arrow
式	Style
弓	Bow
引	Draw
弟	Younger brother
张	Stretch
弥	Fill
弯	Curved
弱	Weak
弹	Bullet
强	Strong
彐	broom (distinguish from writing-brush)
彑	broom (distinguish from writing-brush)
当	Work as
录	Record
彡	shape
形	Shape
彦	Erudite
彩	Hue
影	Shadow
彳	column, line
往	Toward
待	Treat
很	Very
律	Law
得	Must
微	Tiny
德	Morality
心	Heart
忄	state of mind
必	Certainly
忍	Endure
志	Aspiration
忘	Forget
忙	Busy
忧	Worried
快	Fast
念	Miss
忽	Suddenly
怀	Cherish
态	Attitude
怎	How?
怕	Dread
思	Consider
急	Anxious
性	Sex
怪	Peculiar
总	General
恋	Be enamored of
恐	Fear
恩	Kindness
息	Breath
恶	Evil
恼	Annoyed
您	You (respectful)
悬	Suspend
情	Feelings
惊	Startled
惨	Wretched
惯	Accustomed to
想	Think
愁	Gloomy
意	Idea
感	Feel
愿	Wish
慢	Slow
慧	Intelligent
憾	Regret
懂	Understand
戈	Halberd | tasselled arrow (fiesta)
戏	Frolic
成	Turn into
我	I
或	Or
战	War
户	Door
戸	door
房	Domicile
所	Place
扁	Flat
手	Hand
扌	fingers
才	Genius
打	Strike
托	Entrust
执	Clench
扫	Sweep
扭	Twist
批	Criticize
找	Look for
承	Undertake
技	Skill
把	Grasp
抓	Grab
投	Throw
抗	Combat
折	Discount
抚	Comfort
护	Protect
报	Newspaper
抱	Embrace
押	Pawn
抽	Take out
担	Assume
拉	Pull
拐	Turn
招	Beckon
拣	Opt for
括	Include
拳	Boxing
拼	Piece together
拿	Hold
持	Support
挂	Hang
指	Finger
按	Press down on
挥	Brandish
换	Exchange
据	Certificate
授	Confer
掉	Drop
排	Row
探	Spy
接	Welcome
控	Control
推	Push
掩	Conceal
揉	Knead
提	Bring up
握	Grip
揪	Hold tight
搅	Stir
搏	Wrestle
搬	Relocate
摇	Shake
摊	Vendor’s stand
摔	Tumble
摩	Rub
撒	Scatter
播	Broadcast
擦	Scrub
支	Offshoot | branch
攴	taskmaster
攵	taskmaster
收	Receive
改	Alter
攻	Attack
放	Release
政	Politics
故	Deliberately
效	Effect
敌	Enemy
救	Rescue
教	Teach
敞	Spacious
敢	Brave
散	Scattered
敬	Revere
数	Number
整	Entire
文	Literature | sentence (plaid)
斉	adjusted
斗	Big Dipper
料	Material
斤	Catty | axe
斥	Reprimand
斩	Hew
断	Sever
斯	Sphinx
新	New
方	Direction | direction (compass)
施	Execute
旁	Side
旅	Travel
族	Tribe
无	Nothing | waitress
旡	waitress
既	Since
日	Day | sun
旦	Daybreak
旧	Old
旨	Purpose
早	Early
旬	Decameron
旭	Rising Sun
旱	Drought
时	Time
昆	Descendants
昌	Prosperous
明	Bright
昏	Dusk
易	Easy
昔	Times past
星	Star
春	Springtime
昨	Yesterday
昭	Evident
是	Be
显	Obvious
晓	Dawn
晚	Nightfall
晨	Morning
普	Universal
景	Scenery
晶	Sparkling
智	Wisdom
暂	Temporary
暇	Spare time
暗	Dark
曰	Sayeth | tongue-wagging mouth
曲	Bent
更	Even more
曼	Drawn out
曾	Formerly
替	Replace
最	Most
月	Month | moon, month; flesh
有	Possess
朋	Companion
服	Apparel
望	Expect
朝	Dynasty
期	Period of time
木	Tree | tree, wood
未	Not yet
末	Last
本	Notebook
术	Art
机	Machine
杀	Kill
杂	Miscellaneous
李	Plum
杏	Apricot
村	Village
束	Bundle up
条	Strip
来	Come
杯	Cup
松	Pine Tree
板	Plank
极	Extreme
构	Frame
林	Woods
果	Fruit
枝	Branch
枢	Hub
枪	Gun
枯	Withered
架	Shelf
柄	Handle
某	Such and such
染	Dye
柔	Gentle
查	Investigate
柳	Willow
标	Mark
栋	Building
树	Timber
校	School
样	Appearance
核	Nucleus
根	Root
格	Pattern
桃	Peach
案	Case
桌	Table
档	Files
桥	Bridge
梅	Small Plum
梦	Dream
梳	Comb
检	Examine
棉	Cotton
棒	Cudgel
森	Forest
植	Plant
楚	Clear
楼	Multistory building
概	Approximate
模	Imitate
横	Horizontal
欠	Lack | yawn, lack
次	Next
欢	Joyous
欧	Europe
欲	Desire
歌	Song
止	Stop | stop, footprint
正	Correct
此	This (literary)
步	Footstep
武	Military
歯	tooth
歹	Malicious | bones
歺	bones
死	Death
殳	missile
段	Section
毋	mother
母	Mother
每	Every
毒	Poison
比	Compare
毛	Fur | fur, wool
氏	Family name
民	People
气	Air | [spirit]
水	Water
氵	water
永	Eternity
氺	grains of rice
汁	Juice
求	Request
汉	Han
江	Yangtze
池	Pond
汤	Soup
汽	Vapor
沉	Profound
沙	Sand
没	Not have
沫	Foam
河	River
油	Oil
治	Govern
沼	Marsh
泉	Spring
法	Method
泡	Bubbles
波	Waves
泣	Weep
泥	Mud
注	Pour
泰	Tranquil
泳	Swim
泻	Diarrhea
洋	Ocean
洗	Wash
洛	L.A.
洞	Cave
洲	Continent
活	Lively
派	Faction
流	Flow
浅	Shallow
测	Fathom
济	Relieve
浓	Concentrated
浩	Vast
浪	Breakers
浴	Bathe
海	Sea
消	Extinguish
涉	Ford
涨	Swell
液	Liquid
淡	Thin
深	Deep
混	Mix
清	Pure
渐	Gradually
渔	Fishing
渡	Ferry
渣	Sediment
温	Temperature
港	Port
渴	Thirsty
游	Go swimming
湖	Lake
湾	Bay
源	Source
溜	Slide
溶	Dissolve
滑	Slippery
滞	Stagnant
满	Full
滴	Drip
漂	Drift
演	Perform
漠	Desert
漫	Overflow
潮	Tide
激	Excite
火	Fire
灬	oven fire
灭	Destroy
灯	Lamp
灰	Ashes
灵	Spirit
灾	Disaster
炎	Inflammation
点	Spot
烂	Spoiled
烈	Intense
烟	Smoke
烤	Roast
烦	Vexed
烧	Fever
热	Heat
然	Sort of thing
煌	Resplendent
照	Illuminate
熊	Bear
熟	Ripe
爪	Claw
爫	vulture
爱	Love
父	Father
爸	Papa
爻	[double x]
爿	[left-side kata]
片	Slice | one-sided
版	Printing plate
牌	Brand
牙	Tooth | tusk
牛	Cow
物	Thing
特	Special
犬	Pooch | chihuahua
犭	wild dog
犯	Criminal
状	State of affairs
狂	Crazy
狗	Dog
独	Alone
狮	Lion
狱	Prison
猪	Pig
玄	mysterious
率	Rate
玉	Jade | jewel
王	King | king (jewel)
玩	Play
环	Ring
现	Present
珍	Rare
班	Class
球	Ball
理	Logic
瑞	Auspicious
瓜	Melon
瓦	tile
甘	Sweet
甚	Tremendously
生	Life | life (cell)
用	Utilize | utilize (screwdriver)
甫	Fu
田	Rice Field | rice field (brains)
由	Wherefore
甲	First
申	Express
电	Electricity
男	Male
画	Drawing
界	World
留	Stay
略	Abbreviation
番	Try
疋	zoo
疒	sickness
疯	Insane
病	Illness
痛	Ache
癶	teepee
登	Ascend
白	White
百	Hundred
皂	Soap
的	Bull’s Eye
皆	All
皇	Emperor
皮	Covering | pelt
皿	dish
益	Benefit
监	Supervise
盖	Lid
盘	Tray
目	Eye
盲	Blind
直	Straight
相	One another
省	Economize
看	Look at
真	TRUE
眠	Slumber
眨	Blink
眷	Dependents
眼	Eyelet
着	#NAME?
睛	Eyeball
睡	Sleep
督	Superintend
瞄	Aim
矛	Spear | halberd
矢	Dart | dart (distinguish from 弋, arrow)
知	Know
短	Short
石	Stone
砂	Gravel
研	Grind away
破	Break
础	Foundation
硬	Hard
确	Reliable
碌	Commonplace
示	Show | show (altar)
礻	altar
礼	Ceremony
社	Society
祖	Ancestor
神	Gods
票	Ticket
祭	Offer sacrifice
禁	Prohibit
福	Happiness
禸	belt + elbow
离	Leave
禽	Fowl
禾	Standing grain | wheat
秀	Elegant
秋	Autumn
种	Species
科	Academic Discipline
积	Accumulate
称	Weigh
移	Shift
稀	Scarce
程	Journey
穴	Hole
究	Research
空	Empty
穿	Pass through
突	Abruptly
窗	Window
立	Standing up | stand up (vase)
站	Station
竜	dragon
竞	Compete
竟	Unexpectedly
章	Chapter
童	Juvenile
端	Upright
竹	Bamboo
笑	Laugh
笔	Pen
第	No.
等	Etc.
答	Answer
策	Strategy
筷	Chopsticks
简	Simple
算	Calculate
管	Pipe
箱	Box
篇	Piece of writing
篮	Basket
米	Rice
类	Kind
粉	Powder
精	Refined
糖	Sugar
糸	thread
系	Lineage
素	Vegetarian diet
紧	Tight
红	Red
约	Make an appointment
级	Rank
纪	Epoch
纵	Vertical
纸	Paper
线	Line
练	Practice
组	Group
细	Fine
织	Weave
终	End
经	Scripture
结	Tie
给	Give
绝	Discontinue
统	Overall
继	Carry on
绩	Accomplishments
续	Continue
维	Maintain
绿	Green
编	Compile
缶	tin can
缺	Deficient
网	Net | [net crown]
罒	[net crown] | sideways eye
罗	Silk Gauze
罪	Guilt
置	Set Up
羊	Sheep
美	Beautiful
群	Crowd
羽	Feathers
翔	Soar
翻	Turn over
老	Old man
耂	old man
考	Take an exam
者	Someone
而	And | comb
耒	Christmas tree
耳	Ear
聊	Chat
职	Job
联	Unite
聿	brush
肉	Meat
肌	Muscle
肖	Resemble
肚	Belly
股	Thigh
肯	Agree
育	Education
肺	Lungs
胃	Stomach
背	Back
胖	Fat
胜	Victory
胡	Recklessly
胸	Bosom
能	Ability
脂	Grease
脆	Fragile
脉	Blood Vessels
脑	Brain
脚	Foot
脱	Undress
脸	Face
腐	Rotten
腰	Waist
腹	Abdomen
腿	Leg
臣	Feudal Official | retainer (slave)
自	Oneself | oneself (nose)
臭	Stinking
至	Until | climax
臼	mortar
舌	Tongue
舛	sunglasses
舞	Dance
舟	Boat
般	Sort
船	Ship
艮	silver
良	High-quality
色	Color
艳	Gorgeous
艸	[grass]
艹	flower
艺	Technique
节	Holiday
花	Flower
苏	Revive
苗	Seedling
若	As if
苦	Suffering
英	England
茂	Lush
茶	Tea
草	Grass
荣	Glory
荫	Shady
药	Medicine
莫	Nobody
莲	Lotus
获	Seize
菜	Vegetable
营	Camp
落	Fall
著	Author
葬	Inter
蒸	Steam
蓝	Blue
薪	Fuel
虍	tiger
虎	Tiger
虑	Ponder
虚	FALSE
虫	Insect
虽	Although
虾	Shrimp
蚁	Ant
蚊	Mosquito
蛇	Serpent
蛋	Egg
血	Blood
行	Line of business | going (boulevard)
街	Street
衣	Clothing | garment
衤	cloak
补	Patch
表	Surface
衬	Inner Garments
袁	Yuan
袋	Bag
被	Quilt
袭	Raid
裁	Tailor
装	Attire
裙	Skirt
裤	Trousers
襄	Aid
襟	Front of a garment
西	West
覀	Old West | West
要	Want
見	see
见	See
观	Observe
规	Regulations
视	Inspect
觉	Senses
角	Angle
解	Untie
言	Say
警	Police
计	Plan
认	Recognize
讨	Condemn
让	Yield
训	Instructions
记	Remember
讲	Lecture
许	Permit
论	Theory
讽	Mock
设	Establish
证	Evidence
评	Evaluate
识	Knowledge
诉	Accuse
词	Word
试	Test
诗	Poem
诚	Sincere
话	Talk
诞	Nativity
该	Should
语	Language
误	Error
诱	Entice
说	Speak
请	Invite
读	Read
课	Lesson
谁	Who?
调	Tune
谈	Discuss
谜	Riddle
谢	Thank
谨	Careful
谷	Valley
豆	Beans | beans (table)
豕	sow
象	Elephant
豸	skunk
貝	shellfish
贝	Shellfish
贞	Chaste
负	Defeated
贡	Tribute
财	Riches
责	Responsibility
贤	Worthy
败	Fail
货	Commodities
质	Quality
贫	Impoverished
购	Purchase
贮	Store up
贯	Pierce
贱	Cheap
贴	Paste
贵	Expensive
贸	Trade
费	Expense
贺	Congratulate
贼	Burglar
贾	Merchant
贿	Bribe
资	Assets
赋	Levy
赏	Prize
赐	Grant
赔	Compensate
赛	Competition
赠	Make a present of
赤	Crimson | red (red apple)
走	Walk | run
赶	Hurry
起	Begin
超	Transcend
越	Surpass
趣	Interest
足	Lower leg | leg (wooden leg)
跑	Run
跟	Heel
路	Path
跳	Jump
身	Somebody
車	car
车	Car
转	Rotate
轮	Wheel
软	Soft
轻	Lightweight
载	Laden
较	Relatively
辅	Supplement
辉	Radiance
输	Transport
辛	Peppery | spicy
辟	Repudiate
辣	Spicy Hot
辩	Dispute
辰	Sign of the Dragon
辵	road
辶	road
边	Border
达	Reach
迅	Speedy
过	Cross
迈	Stride
迎	Greet
运	Carry
近	Near
返	Go back
还	Give back
这	This
进	Advance
远	Distant
连	One after another
述	Narrate
迷	Lost
追	Chase
退	Retreat
送	Deliver
适	Suitable
逃	Escape
选	Choose
逊	Modest
透	Penetrate
逐	Pursue
途	Route
通	Communicate
逛	Stroll
逝	Pass away
速	Quick
造	Create
逸	Flee
逾	Exceed
遇	Encounter
道	Way
遗	Bequeath
遥	Remote
遵	Abide by
避	Evade
邑	city walls
那	That
郎	Young man
部	Department
都	Metropolis
酉	sign of the bird (whiskey bottle)
酋	Chieftain
配	Distribute
酒	Liquor
釆	animal tracks
采	Pick
释	Explain
里	Li | ri (computer)
重	Heavy
野	Wild
量	Quantity
金	Gold | gold, metal
针	Needle
钉	Nail
钓	Go fishin’
钟	Bell
钱	Coin
铁	Iron
铜	Copper
铭	Inscription
银	Silver
错	Mistaken
锤	Hammer
锯	Saw
锻	Forge
镇	At ease
镜	Mirror
長	long
长	Long
門	gate
门	Gate
问	Ask
闲	Leisure
间	Interval
闻	Hear
阜	pinnacle
阝	(on left 防) pinnacle | (on right 郊) city walls
队	Team
防	Ward off
阳	Yang
阴	Yin
阵	Battle formation
阶	Stairs
阿	Apollo
附	Attach
际	Occasion
陆	Land
陈	Exhibit
降	Descend
限	Limit
院	Inst.
除	Eliminate
险	Perilous
随	As you wish
隶	sieve
隹	turkey
难	Difficult
雁	Wild goose
雄	Grand
集	Gather
雇	Hire
雨	Rain
雪	Snow
零	Zero
雷	Thunder
雾	Fog
需	Need
霜	Frost
露	Dew
青	Blue or green | blue
静	Quiet
非	Non- | jail cell
靠	Lean on
面	Face-to-face | mask
革	Leather
鞋	Shoes
韋	locket
韦	Tanned hide
韭	[leek]
音	Sound
韵	Rhyme
頁	page (head)
页	Page
顶	Crest
项	Item
顺	Obey
须	Have to
顽	Stubborn
顾	Look Back
预	Beforehand
领	Collar
频	Repeatedly
颗	Granule
题	Topic
颜	Countenance
额	Forehead
風	wind
风	Wind
飛	fly
飞	Fly
食	Food | eat, food
餐	Dine
饭	Meal
馆	Bldg.
首	Heads | neck
香	Perfume | incense
馨	Fragrant
馬	horse
马	Horse
骂	Scold
验	Check
骑	Ride
骨	Skeleton
高	Tall
髟	[long hair]
鬥	[broken gate]
鬯	[fragrant herbs]
鬲	[tripod]
鬼	Ghost
魔	Demon
魚	fish
鱼	Fish
鲜	Fresh
鳥	bird
鸟	Bird
鸡	Chicken
鸭	Duck
鹰	Hawk
鹵	rocksalt (RTK 3)
鹿	Deer
麥	[wheat] (original form of barley)
麦	Wheat
麻	Hemp
黄	Yellow
黍	millet (RTK 3)
黑	Black | black (original form)
黒	black
默	Silent
黹	[sewing]
黽	[green frog]
鼎	tripod (RTK 3)
鼓	Drum
鼠	mouse (RTK 3)
鼻	Nose
齐	Identical
龙	Dragon
龠	[flute]
